####################
#                  #
#                  #
#    ====          #
#                  #
#         ====     #
#                  #
####################
